_________
__oo_o_o_
o__o__x__
__oo__o__
__po__o_w
ooooxxooo
